street	Location
convenient	Location
block	Location
avenue	Location
river	Location
drinks	Drinks
beverage	Drinks
wines	Drinks
margaritas	Drinks
sake	Drinks
food	Food
spicy	Food
sushi	Food
pizza	Food
tasty	Food
romantic	Ambience
atmosphere	Ambience
room	Ambience
seating	Ambience
small	Ambience
tips	Service
manager	Service
wait	Service
waitress	Service
servers	Service