support	Support
service	Support
replace	Support
warrenty	Support
coverage	Support
Windows	OS
os	OS
IOS	OS
Mac	OS
system	OS
screen	Display
LED	Display
display	Display
monitor	Display
color	Display
battery	Battery
life	Battery
charge	Battery
last	Battery
hour	Battery
mouse	Mouse
touch	Mouse
track	Mouse
button	Mouse
pad	Mouse
programs	Software
software	Software
applications	Software
iTunes	Software
photo	Software
keyboard	Keyboard
key	Keyboard
space Keyboard